Công nghệ thông tin
IT Phần cứng - Mạng
IT Phần mềm
Hành chính - Thư ký
Khách sạn - Nhà hàng - Du lịch
Bán sỉ - Bán lẻ - Quản lý cửa hàng
Marketing
Bán hàng - Kinh doanh
Kế toán
Tài chính - Đầu tư - Chứng Khoán
Kiểm toán
Khoa học - Kỹ thuật
An ninh - Bảo vệ
Thiết kế - Sáng tạo nghệ thuật
Kiến trúc - Thiết kế nội ngoại thất
Sản xuất - Lắp ráp - Chế biến
Vận hành - Bảo trì - Bảo dưỡng
Nông - Lâm - Ngư nghiệp
Thu mua - Kho Vận - Chuỗi cung ứng
Xuất Nhập Khẩu
Vận Tải - Lái xe - Giao nhận
Ngân hàng
Khai thác năng lượng - Khoáng sản Địa chất
Y tế - Chăm sóc sức khỏe
Nhân sự
Bảo hiểm
Thông tin - Truyền thông - Quảng cáo
Luật - Pháp Lý - Tuân thủ
Quản lý dự án
Quản lý tiêu chuẩn và chất lượng
Bất động sản
Chăm sóc khách hàng
Xây dựng
Giáo dục - Đào tạo
Phân tích - Thống kê dữ liệu
An toàn lao động
Biên phiên dịch
Bưu chính viễn thông
Dầu khí
Dệt may - Da giày - Thời trang
Điện - Điện tử - Điện lạnh
Dược phẩm
Hóa học - Hóa sinh
Môi trường - Xử lý chất thải
Thực phẩm - Đồ uống
Chăn nuôi - Thú y
Cơ khí - Ô tô - Tự động hóa
Công nghệ thực phẩm - Dinh dưỡng
Lao động phổ thông
Phi chính phủ - Phi lợi nhuận
Truyền hình - Báo chí - Biên tập
Xuất bản - In ấn
Thực tập sinh